..................#...#........
..................#...#........
..................#...#........
............#.....#...#........
.......#..........#...#........
....#..#..........#............
....#..#..........#...#######..
....#..################........
....#........#.................
....#........#.................
.............#.................
.............#.................
...............................
..................#####........
..................#...#........
..................#...#........
..................#...#........
..................#...#........
..................#...#........
..................#...#........
..................#...#........
...............................
...............................
...............................
...............................
...............................
...............................
...............................
...............................
...............................
...............................
